4 4 4 4 4 4 4 4 4 4 4 4 4 4
4 11 11 11 11 11 4 4 11 11 11 11 11 4
4 11 11 11 11 11 4 4 11 11 11 11 11 4
4 11 11 11 11 11 4 4 11 11 11 11 11 4
4 4 4 4 4 4 4 4 4 4 4 4 12 4
4 4 4 4 4 4 4 4 4 4 4 4 12 4
4 10 4 4 4 4 4 4 4 4 4 10 10 4
4 10 4 4 4 4 9 9 4 4 4 10 10 4
4 10 10 10 10 3 9 9 5 10 10 10 10 4
4 4 4 4 4 4 4 4 4 4 4 4 4 4