4 4 4 4 4 4 4 4 4 4 4 4 4 4
4 10 10 10 10 10 9 9 10 10 10 10 10 4
4 10 4 4 4 9 9 9 9 4 4 4 10 4
4 10 4 4 9 9 9 9 9 4 4 4 10 4
4 4 4 4 9 9 9 9 9 9 4 4 10 4
4 4 4 10 9 9 9 9 9 9 4 4 10 4
4 10 10 4 4 9 9 9 9 9 4 4 10 4
4 10 4 4 10 9 9 9 9 4 4 4 10 4
4 10 4 4 10 10 9 9 10 10 10 10 10 4
4 4 4 4 4 4 4 4 4 4 4 4 4 4